############
#        O #
#   P   ####
#          #
#######    #
#  O ##    #
#    ##   O#
#          #
#      XX  #
#      #   #
############
