############
#        O #
#   P   ####
#   NOT    #
#######    #
#  O ##    #
#    ##    #
#   WORK   #
#      XX  #
#      #   #
############
